BAD: a
BAF: able
BAG: about
BAH: above
BAJ: accept
BAK: across
BAL: act
BAM: actually
BAN: add
BAP: admit
BAR: afraid
BAS: after
BAT: afternoon
BAV: again
BAZ: against
BIB: age
BID: ago
BIF: agree
BIG: ahead
BIH: air
BIJ: alive
BIK: all
BIL: allow
BIM: almost
BIN: alone
BIP: along
BIR: already
BIS: also
BIT: although
BIV: always
BIZ: among
BOB: and
BOD: angry
BOF: animal
BOG: another
BOH: answer
BOJ: any
BOK: anybody
BOL: anymore
BOM: anyone
BON: anything
BOP: anyway
BOR: anywhere
BOS: apartment
BOT: appear
BOV: approach
BOZ: area
BUB: arm
BUD: around
BUF: arrive
BUG: art
BUH: as
BUJ: ask
BUK: asleep
BUL: at
BUM: attack
BUN: attention
BUP: aunt
BUR: avoid
BUS: away
BUT: baby
BUV: back
BUZ: bad
DAB: bag
DAD: ball
DAF: bank
DAG: bar
DAH: barely
DAJ: bathroom
DAK: be
DAL: beach
DAM: bear
DAN: beat
DAP: beautiful
DAR: because
DAS: become
DAT: bed
DAV: bedroom
DAZ: beer
DIB: before
DID: begin
DIF: behind
DIG: believe
DIH: belong
DIJ: below
DIK: bend
DIL: beneath
DIM: beside
DIN: best
DIP: better
DIR: between
DIS: beyond
DIT: big
DIV: bird
DIZ: bit
DOB: bite
DOD: black
DOF: block
DOG: blood
DOH: blow
DOJ: blue
DOK: board
DOL: boat
DOM: body
DON: bone
DOP: book
DOR: boot
DOS: bore
DOT: both
DOV: bother
DOZ: bottle
DUB: bottom
DUD: box
DUF: boy
DUG: brain
DUH: branch
DUJ: break
DUK: breast
DUL: breath
DUM: breathe
DUN: bridge
DUP: bright
DUR: bring
DUS: brother
DUT: brown
DUV: building
DUZ: burn
FAB: bus
FAD: business
FAF: busy
FAG: but
FAH: buy
FAJ: by
FAK: call
FAL: calm
FAM: camera
FAN: can
FAP: car
FAR: card
FAS: care
FAT: careful
FAV: carefully
FAZ: carry
FIB: case
FID: cat
FIF: catch
FIG: cause
FIH: ceiling
FIJ: center
FIK: certain
FIL: certainly
FIM: chair
FIN: chance
FIP: change
FIR: check
FIS: cheek
FIT: chest
FIV: child
FIZ: choice
FOB: choose
FOD: church
FOF: cigarette
FOG: circle
FOH: city
FOJ: class
FOK: clean
FOL: clear
FOM: clearly
FON: climb
FOP: close
FOR: clothes
FOS: cloud
FOT: coat
FOV: coffee
FOZ: cold
FUB: college
FUD: color
FUF: come
FUG: company
FUH: completely
FUJ: computer
FUK: confuse
FUL: consider
FUM: continue
FUN: control
FUP: conversation
FUR: cool
FUS: cop
FUT: corner
FUV: count
FUZ: counter
GAB: country
GAD: couple
GAF: course
GAG: cover
GAH: crazy
GAJ: create
GAK: creature
GAL: cross
GAM: crowd
GAN: cry
GAP: cup
GAR: cut
GAS: dad
GAT: dance
GAV: dark
GAZ: darkness
GIB: daughter
GID: day
GIF: dead
GIG: death
GIH: decide
GIJ: deep
GIK: desk
GIL: despite
GIM: die
GIN: different
GIP: dinner
GIR: direction
GIS: dirt
GIT: disappear
GIV: discover
GIZ: distance
GOB: do
GOD: doctor
GOF: dog
GOG: door
GOH: doorway
GOJ: down
GOK: dozen
GOL: drag
GOM: draw
GON: dream
GOP: dress
GOR: drink
GOS: drive
GOT: driver
GOV: drop
GOZ: dry
GUB: during
GUD: dust
GUF: each
GUG: ear
GUH: early
GUJ: earth
GUK: easily
GUL: east
GUM: easy
GUN: eat
GUP: edge
GUR: effort
GUS: egg
GUT: eight
GUV: either
GUZ: else
HAB: empty
HAD: end
HAF: engine
HAG: enjoy
HAH: enough
HAJ: enter
HAK: entire
HAL: especially
HAM: even
HAN: event
HAP: ever
HAR: every
HAS: everybody
HAT: everyone
HAV: everything
HAZ: everywhere
HIB: exactly
HID: except
HIF: excite
HIG: expect
HIH: explain
HIJ: expression
HIK: extra
HIL: eye
HIM: face
HIN: fact
HIP: fade
HIR: fail
HIS: fall
HIT: familiar
HIV: family
HIZ: far
HOB: fast
HOD: father
HOF: fear
HOG: feed
HOH: feel
HOJ: few
HOK: field
HOL: fight
HOM: figure
HON: fill
HOP: final
HOR: finally
HOS: find
HOT: fine
HOV: finger
HOZ: finish
HUB: fire
HUD: first
HUF: fish
HUG: fit
HUH: five
HUJ: fix
HUK: flash
HUL: flat
HUM: flight
HUN: floor
HUP: flower
HUR: fly
HUS: follow
HUT: food
HUV: foot
HUZ: for
JAB: force
JAD: forehead
JAF: forest
JAG: forever
JAH: forget
JAJ: form
JAK: forward
JAL: four
JAM: free
JAN: fresh
JAP: friend
JAR: from
JAS: front
JAT: fuck
JAV: full
JAZ: fun
JIB: funny
JID: future
JIF: game
JIG: garden
JIH: gate
JIJ: gather
JIK: gently
JIL: get
JIM: gift
JIN: girl
JIP: give
JIR: glance
JIS: glass
JIT: go
JIV: god
JIZ: gold
JOB: good
JOD: grab
JOF: grandfather
JOG: grandmother
JOH: grass
JOJ: gray
JOK: great
JOL: green
JOM: ground
JON: group
JOP: grow
JOR: guard
JOS: guess
JOT: gun
JOV: guy
JOZ: hair
JUB: half
JUD: hall
JUF: hallway
JUG: hand
JUH: hang
JUJ: happen
JUK: happy
JUL: hard
JUM: hardly
JUN: hate
JUP: have
JUR: he
JUS: head
JUT: hear
JUV: heart
JUZ: heat
KAB: heavy
KAD: hell
KAF: hello
KAG: help
KAH: her
KAJ: here
KAK: herself
KAL: hey
KAM: hi
KAN: hide
KAP: high
KAR: hill
KAS: him
KAT: himself
KAV: history
KAZ: hit
KIB: hold
KID: hole
KIF: home
KIG: hope
KIH: horse
KIJ: hospital
KIK: hot
KIL: hotel
KIM: hour
KIN: house
KIP: how
KIR: however
KIS: huge
KIT: human
KIV: hundred
KIZ: hurry
KOB: hurt
KOD: husband
KOF: I
KOG: ice
KOH: idea
KOJ: if
KOK: ignore
KOL: image
KOM: imagine
KON: immediately
KOP: important
KOR: in
KOS: information
KOT: inside
KOV: instead
KOZ: interest
KUB: into
KUD: it
KUF: itself
KUG: jacket
KUH: job
KUJ: join
KUK: joke
KUL: jump
KUM: just
KUN: keep
KUP: key
KUR: kick
KUS: kid
KUT: kill
KUV: kind
KUZ: kiss
LAB: kitchen
LAD: knee
LAF: knife
LAG: knock
LAH: know
LAJ: lady
LAK: land
LAL: language
LAM: large
LAN: last
LAP: later
LAR: laugh
LAS: law
LAT: lay
LAV: lead
LAZ: leaf
LIB: lean
LID: learn
LIF: leave
LIG: leg
LIH: less
LIJ: let
LIK: letter
LIL: lie
LIM: life
LIN: lift
LIP: light
LIR: like
LIS: line
LIT: lip
LIV: listen
LIZ: little
LOB: local
LOD: lock
LOF: long
LOG: look
LOH: lose
LOJ: lot
LOK: loud
LOL: love
LOM: low
LON: lucky
LOP: lunch
LOR: machine
LOS: main
LOT: make
LOV: man
LOZ: manage
LUB: many
LUD: map
LUF: mark
LUG: marriage
LUH: marry
LUJ: matter
LUK: may
LUL: maybe
LUM: me
LUN: mean
LUP: meet
LUR: member
LUS: memory
LUT: mention
LUV: message
LUZ: metal
MAB: middle
MAD: might
MAF: mind
MAG: mine
MAH: minute
MAJ: mirror
MAK: miss
MAL: moment
MAM: money
MAN: month
MAP: moon
MAR: more
MAS: morning
MAT: most
MAV: mostly
MAZ: mother
MIB: mountain
MID: mouth
MIF: move
MIG: movie
MIH: much
MIJ: music
MIK: must
MIL: my
MIM: myself
MIN: name
MIP: narrow
MIR: near
MIS: nearly
MIT: neck
MIV: need
MIZ: neighbor
MOB: never
MOD: new
MOF: news
MOG: next
MOH: nice
MOJ: night
MOK: no
MOL: nobody
MOM: nod
MON: noise
MOP: none
MOR: nor
MOS: normal
MOT: north
MOV: nose
MOZ: not
MUB: note
MUD: nothing
MUF: notice
MUG: now
MUH: number
MUJ: nurse
MUK: of
MUL: off
MUM: offer
MUN: office
MUP: officer
MUR: often
MUS: oh
MUT: okay
MUV: old
MUZ: on
NAB: once
NAD: one
NAF: only
NAG: onto
NAH: open
NAJ: or
NAK: order
NAL: other
NAM: our
NAN: out
NAP: outside
NAR: over
NAS: own
NAT: page
NAV: pain
NAZ: paint
NIB: pair
NID: pale
NIF: palm
NIG: pants
NIH: paper
NIJ: parent
NIK: part
NIL: party
NIM: pass
NIN: past
NIP: path
NIR: pause
NIS: pay
NIT: people
NIV: perfect
NIZ: perhaps
NOB: personal
NOD: phone
NOF: photo
NOG: pick
NOH: picture
NOJ: piece
NOK: pile
NOL: pink
NOM: place
NON: plan
NOP: plastic
NOR: plate
NOS: play
NOT: please
NOV: pocket
NOZ: point
NUB: police
NUD: pool
NUF: poor
NUG: pop
NUH: porch
NUJ: position
NUK: possible
NUL: pour
NUM: power
NUN: prepare
NUP: press
NUR: pretend
NUS: pretty
NUT: probably
NUV: problem
NUZ: promise
PAB: prove
PAD: pull
PAF: push
PAG: put
PAH: question
PAJ: quick
PAK: quickly
PAL: quiet
PAM: quietly
PAN: quite
PAP: radio
PAR: rain
PAS: raise
PAT: rather
PAV: reach
PAZ: read
PIB: ready
PID: real
PIF: realize
PIG: really
PIH: reason
PIJ: receive
PIK: recognize
PIL: red
PIM: refuse
PIN: remain
PIP: remember
PIR: remind
PIS: remove
PIT: repeat
PIV: reply
PIZ: rest
POB: return
POD: reveal
POF: rich
POG: ride
POH: right
POJ: ring
POK: rise
POL: river
POM: road
PON: rock
POP: roll
POR: roof
POS: room
POT: round
POV: row
POZ: rub
PUB: run
PUD: rush
PUF: sad
PUG: safe
PUH: same
PUJ: sand
PUK: save
PUL: say
PUM: scared
PUN: scene
PUP: school
PUR: scream
PUS: screen
PUT: sea
PUV: search
PUZ: seat
RAB: second
RAD: see
RAF: seem
RAG: sell
RAH: send
RAJ: sense
RAK: serious
RAL: seriously
RAM: serve
RAN: service
RAP: set
RAR: settle
RAS: seven
RAT: several
RAV: sex
RAZ: shadow
RIB: shake
RID: shape
RIF: share
RIG: sharp
RIH: she
RIJ: sheet
RIK: ship
RIL: shit
RIM: shirt
RIN: shoe
RIP: shoot
RIR: shop
RIS: short
RIT: should
RIV: shoulder
RIZ: shout
ROB: shove
ROD: show
ROF: shower
ROG: shrug
ROH: shut
ROJ: sick
ROK: side
ROL: sigh
ROM: sight
RON: sign
ROP: silence
ROR: silent
ROS: silver
ROT: simple
ROV: simply
ROZ: since
RUB: sing
RUD: single
RUF: sir
RUG: sister
RUH: sit
RUJ: situation
RUK: six
RUL: size
RUM: skin
RUN: sky
RUP: slam
RUR: sleep
RUS: slide
RUT: slightly
RUV: slip
RUZ: slow
SAB: slowly
SAD: small
SAF: smell
SAG: smile
SAH: smoke
SAJ: snap
SAK: snow
SAL: so
SAM: soft
SAN: softly
SAP: soldier
SAR: somebody
SAS: somehow
SAT: someone
SAV: something
SAZ: sometimes
SIB: somewhere
SID: son
SIF: song
SIG: soon
SIH: sorry
SIJ: sort
SIK: soul
SIL: sound
SIM: south
SIN: space
SIP: speak
SIR: special
SIS: spend
SIT: spin
SIV: spirit
SIZ: spot
SOB: spread
SOD: spring
SOF: stage
SOG: stair
SOH: stand
SOJ: star
SOK: stare
SOL: start
SOM: state
SON: station
SOP: stay
SOR: steal
SOS: step
SOT: stick
SOV: still
SOZ: stomach
SUB: stone
SUD: stop
SUF: store
SUG: storm
SUH: story
SUJ: straight
SUK: strange
SUL: street
SUM: stretch
SUN: strike
SUP: strong
SUR: student
SUS: study
SUT: stuff
SUV: stupid
SUZ: such
TAB: suddenly
TAD: suggest
TAF: suit
TAG: summer
TAH: sun
TAJ: suppose
TAK: sure
TAL: surface
TAM: surprise
TAN: sweet
TAP: swing
TAR: system
TAS: table
TAT: take
TAV: talk
TAZ: tall
TIB: tea
TID: teach
TIF: teacher
TIG: team
TIH: tear
TIJ: television
TIK: tell
TIL: ten
TIM: terrible
TIN: than
TIP: thank
TIR: that
TIS: the
TIT: their
TIV: them
TIZ: themselves
TOB: then
TOD: there
TOF: these
TOG: thick
TOH: thin
TOJ: thing
TOK: think
TOL: third
TOM: thirty
TON: this
TOP: those
TOR: though
TOS: three
TOT: throat
TOV: through
TOZ: throw
TUB: tie
TUD: time
TUF: tiny
TUG: tire
TUH: to
TUJ: today
TUK: together
TUL: tomorrow
TUM: tone
TUN: tongue
TUP: tonight
TUR: too
TUS: tooth
TUT: top
TUV: toss
TUZ: touch
VAB: toward
VAD: town
VAF: track
VAG: train
VAH: travel
VAJ: tree
VAK: trip
VAL: trouble
VAM: truck
VAN: true
VAP: trust
VAR: truth
VAS: try
VAT: turn
VAV: twenty
VAZ: twice
VIB: two
VID: uncle
VIF: under
VIG: understand
VIH: unless
VIJ: until
VIK: up
VIL: upon
VIM: use
VIN: usual
VIP: usually
VIR: very
VIS: view
VIT: village
VIV: visit
VIZ: voice
VOB: wait
VOD: wake
VOF: walk
VOG: wall
VOH: want
VOJ: war
VOK: warm
VOL: wash
VOM: watch
VON: water
VOP: wave
VOR: way
VOS: we
VOT: wear
VOV: wedding
VOZ: week
VUB: weight
VUD: well
VUF: west
VUG: wet
VUH: what
VUJ: whatever
VUK: wheel
VUL: when
VUM: where
VUN: whether
VUP: which
VUR: while
VUS: whisper
VUT: white
VUV: who
VUZ: whole
ZAB: whom
ZAD: whose
ZAF: why
ZAG: wide
ZAH: wife
ZAJ: wild
ZAK: will
ZAL: win
ZAM: wind
ZAN: window
ZAP: wine
ZAR: wing
ZAS: winter
ZAT: wipe
ZAV: wish
ZAZ: with
ZIB: within
ZID: without
ZIF: woman
ZIG: wonder
ZIH: wood
ZIJ: wooden
ZIK: word
ZIL: work
ZIM: world
ZIN: worry
ZIP: would
ZIR: wrap
ZIS: write
ZIT: wrong
ZIV: yard
ZIZ: yeah
ZOB: year
ZOD: yell
ZOF: yellow
ZOG: yes
ZOH: yet
ZOJ: you
ZOK: young
ZOL: your
ZOM: yourself
